0 0 0 0 0 0 0 0 0 0 0 0 0 0 0 0
0 0 0 0 0 0 0 0 0 0 0 0 0 0 0 0
1 1 1 0 0 0 0 0 0 0 0 0 0 0 0 0
0 0 0 0 0 0 0 0 0 0 0 0 0 0 0 0
0 0 0 0 0 0 0 0 0 0 0 0 0 0 0 0
0 0 0 0 0 0 0 0 0 0 0 0 0 0 0 0
0 0 0 0 0 0 0 0 0 0 0 0 0 0 0 0
0 0 0 0 0 0 0 0 0 0 0 0 0 0 0 0
1 2 2 2 2 2 0 0 0 2 2 2 2 2 2 3
4 5 5 5 5 5 0 0 0 5 5 5 5 5 5 6
4 5 5 5 5 5 0 0 0 5 5 5 5 5 5 6
7 8 8 8 8 8 0 0 0 8 8 8 8 8 8 9